######
#.!.!#
#.!..#
#@.!.#
#....#
######