######
#!##!#
#.!.!#
#@...#
#!.!.#
######