................
................
...@............
....########....
....########....
....########....
....########....
....########....
....########....
............!...
................
................