..############..
.#@...........#.
.#...##..##...#.
.#...##..##!..#.
.#............#.
.#............#.
.#...!.....!..#.
.#....####....#.
.#...#....#...#.
.#..#......#..#.
.#............#.
..############..