................
................
....#..@..#.....
....#.....#.....
....#.....#.....
....#.....#.....
....#.....#.....
....#.....#.....
.#!.........!#..
..###########...
................
................