................
.#..............
.#...######.....
.#@..#....#.....
.#####....#.....
..!.......#..##.
....###...#..#..
....#.#...#..#..
....#.#####..#..
....#........#..
....##########..
.....!..........