..@.............
.....######.....
.....#....#.....
..!..#....#.....
.....######...!.
.......##.......
...##########...
.......##.......
.......##.......
..!....##!......
....########....
....#......#....