................
...#...##...#...
..@....##.......
...##......##...
...##......##...
...##......##...
...##......##...
...##......##...
...##.!..!.##...
.......##.......
...#...##...#...
................
