................
.#.#.@......#.#.
............#.#.
.#.#............
.#.#........#.#.
.......##...#.#.
.#.#...##.......
.#.#........#.#.
............#.#.
.#.#............
.#.#!......!#.#.
................