###.#...#.###.!.
#.#@.#.#...#....
#.#...#....#....
#.#..#.....#....
................
#..#.#..#.#.....
#.##.####.#.....
##.#.#..#.....!.
#..#.#..#.#.....
................
.##############.
................