......@.........
..#####..#####..
..#...#..#...#..
..#...#..#...#..
..#####..#####..
................
...!........!...
..#####..#####..
..#...#..#...#..
..#...#..#...#..
..#...#..#...#..
..#####..#####..