################
#####!........##
####.........###
###.........####
##.........#####
#..............#
#.......@......#
#####.........##
####.........###
###.........####
##........!#####
################