@...............
.#.....########.
..#.............
...#............
....#......!....
.....#..........
......#........#
.......#......#.
...!....#....#..
.........#..#...
.#####....##....
................