................
.####.####.####.
..@....##.......
.......##.......
.####.####.####.
................
................
.####.####.####.
..!....##..!....
.......##.......
.####.####.####.
.......!........