################
#..............#
#.############.#
#.#............#
#@#.############
###.#...........
..#.#...........
..#.#...#..!....
..#.#...#.......
..#.#####.......
................
!..............!