.......@........
.....#####......
.....#####......
......###.......
......###.......
.!..########....
...##########...
....########....
......###.!.....
......###.......
.!....###.....!.
......###.......
