.###@......###..
................
.#####....#####.
................
.######..######.
................
.######..######.
................
.#####....#####.
................
.###.!....!.###.
................