###########
#!....##..#
#....!....#
#......##.#
#@....#...#
#...!...#.#
######...#
#....!!...#
#.......!.#
#.......!.#
###########