################
.#..@.........#.
#......##......#
.#.....##.....#.
#...........!..#
.#....####....#.
#.....#..#.....#
.#....#..#.!..#.
#.....####.....#
.#..!.........#.
#.......!......#
################