..#.@.....######
..#......######.
###.....######..
...#...######...
.............#..
.!...........!..
................
..#...!.........
...######...#...
..######.....###
.######......#..
######..!....#..