#########
#.!.....#
#.####..#
#.#.@#..#
#.##....#
#.####..#
#.......#
#.....!.#
#########