......@.......#.
....######...#..
..#.............
#........#......
.......#.....#..
.#..#..#........
...#.....!#.....
..#.......#.....
...#...##.......
.....#......!...
.#..!..#...#....
........#.#.....